F 50,50,50
C 144,215,236
EA ../Textures/bluestone.xpm
SO ../Textures/bluestone.xpm
WE ../Textures/bluestone.xpm
NO ../Textures/bluestone.xpm
1111111111111111111111111111111111111111
1111111111111111111111111111111111111111
1111111111111111111111111111111111111111
1111111111111111111111111111111111111111
1111111111101111111111111111111111101111
1111111111111111111111111111111111111111
1111111111111111111111111111111111111111
1111111111111111111111111111111111111111
1111111111111111111111111111111111111111
1111111111111111111111111111111111111111
1111100111111111111111111111111111111111
1110000111111111111111111111111111111111
1100110111111111111111111111111111111111
1101100011111111111111111111110111111111
1100001111111111111111111111111111111111
1100000111111111111111111111111111111111
1110000111111111111111111111111111111111
1110000111111110011111111111111111111111
1000000111000000000001111111111111111101
1000000000000000000001111111111111111111
1000000000000011000001111111111111111111
1000000000100011110001111111111111111111
1000000000000011111111111111111111111111
1000000000000001111111111111111111111111
1000000000000100111111111111111111111111
1000000111111110111111111111111111111111
1000000000001110111111111111111111111111
1000000011101110001111111111111111111111
1000000011101110001111111111111111111111
1000011111100110111111111111111111111011
1000001111110000001111111111111111111111
1000001111110000000111111111111111111111
1000000111110000000001111111111111111111
1000000000010100000001111111111111111111
10000000000000010001111111110000N1111111
1000011000100000000000111111000111111111
1000011000000000000000111111000111111111
1000000000000000100000011111110111111111
1000100100000000000001000000000111111111
1111111111111111111111111111111111111111
